NO ./textures/dark_texture.xpm
SO ./textures/green_texture.xpm
WE ./textures/orange_texture.xpm
EA ./textures/purple_texture.xpm

F 225, 252, 225
C 168, 169, 167

1111111111111111111111111111111111111111111111111111111111111111111111111111
1E00000000000000000000000000000000000100000000000000000000000000000000000001
1000000000000000000000000000000000000100000000000000000000000000000000000001
1001001111111111111111111111111100100100000000000000000000000000000000000001
1001000000000000000000000000000100100100000000000100000000000000000000000001
1001111111111111111111111111100100100100000000000100000000000000000000000001
1001000000000000000000000000100100100100000000000100000000000000000000000001
1001000000000000000000000000100100100100000000100100000000000000000000000001
1001000000000000000000001000100100100100000000100100000000000000000000000001
1001000000000000000000001000100100100000000000100100000000000000000000000001
1001000000000000000000001000100100100001001000100100000000000000000000000001
1001000000000000000000001000100100100001001000100100000000000000000000000001
1001000000000000000000001000000100100001001000100100000000000000000000000001
1001000000000000000000001000000100100001001000100100000000000000000000000001
1001111111111111111111111111111100100001001000100100000000000000000000000001
1000000000000000000000000000000000000001001000100100000000000000000000000001
1000000000000000000000000000000000000001001000100000000000000000000000000001
1001111111111111111111111111111100100001001000100000000000000000000000000001
1001000000000000000000000000000100100001001000100000000000000000000000000001
1001000000000000000000000000000100100001001000000000000000000000000000000001
1001000000000000000000000100100100100001001000000000000000000000000000000001
1001000000000000000000000100100100100001001000000000000000000000000000000001
1001000000000000000000000100100100100000000000000000000000000000000000000001
1001000000000000000000000100100100100000000000000000000000000000000000000001
1001000000000000000000000100100100100000000000000000000000000000000000000001
1001000000000000000000000100100100100000000000000000000000000000000000000001
1001000000000000000000000100100100100000000000000000000000000000000000000001
1001000000000000000000000100100100100000000000000000000000000000000000000001
1001000000000000000000000100100100111111111111111111111111100000000000000001
1001000000000000000000000100100000000000000000000000000000000000000000000001
1001000000000000000000000100100000000000000000000000000000000000000000000001
1001000000000000000000000100100000111111111111111111111111100000000000000001
1000000000000000000000000000000100000000000000000000000000000000000000000001
1000000000000000000000000000000100000000000000000000000000000000000000000001
1111111111111111111111111111111111111111111111111111111111111111111111111111
