NO ./textures/dark_texture.xpm
SO ./textures/green_texture.xpm
WE ./textures/orange_texture.xpm
EA ./textures/purple_texture.xpm

F 225, 252, 225
C 168, 169, 167

    1111111111
    1000000001
11111100001101
10111111010001
10111111011111
10000E0001
1111111111