NO ./textures/dark_texture.xpm
SO ./textures/green_texture.xpm
WE ./textures/orange_texture.xpm
EA ./textures/purple_texture.xpm

F 225, 252, 225
C 168, 169, 167

11111111111
10000000001
111111000W1
10111100001
10111111011
10000110001
10000000011
11111111111